###################
#........#........#
#.##.###.#.###.##.#
#.##.###.#.###.##.#
#.................#
#.##.#.#####.#.##.#
#....#...#...#....#
####.###.#.###.####
   #.#...B...#.#   
####.#.## ##.#.####
    ...#PIC#...    
####.#.#####.#.####
   #.#...G...#.#   
####.#.#####.#.####
#........#........#
#.##.###.#.###.##.#
#..#...........#..#
##.#.#.#####.#.#.##
#....#...#...#....#
#.######.#.######.#
#.................#
###################